###################################
#   #         #   #   #     # # #E#
# # ### ######### # # # ### # # ###
# # #   #           #   #         #
# # # ### ######### ##### ### ### #
# # # # #   #     #   #     # # # #
### # # ### # # ### # # # ### # ###
#S            #   # # # # #   #   #
###################################